.....╔══╦═══╗...........
════╗║..█...║......█....
.╔══╬╝..╔═══╣...╗..║....
.║..║...║...╚═╦═╝╚╦╝....
.╚╦═╩═══╣.....║...║.....
..╚══█..║.....╚═╦═╝.....
........█.......╚█......
........................